1,1,1,1,1,1,1,1,1
1,1,1,p,q,r,1,1,1
1,1,1,o,1,1,s,1,1
1,a,c,d,1,i,j,1,1
1,b,t,n,e,v,k,u,1
1,1,1,1,f,m,l,1,1
1,1,1,1,g,1,1,1,1
1,1,1,1,h,1,1,1,1
1,1,1,1,1,1,1,1,1